PPPPPPPPPPPPPPPPPPPPPPPPPPPPPPPPPPPPPPPPPPPPPPPPPPPPPPPPPPPPPPPPPPPPPPPP
P                                                                      P
P                                                                      P
P                                                                      P
P                                                           T          P
P                                  PPPW                    PPP         P
P            E    D  +                P  PPPP   W                      P
P    PPP   PPPPP PPP P        T                 P T                    P
P                  W     N   PPP              WPPPPPPPPP               P
P                  P   PPPPP                  P                  PPPP GP
PS        N           D T                  TD            E  E   N     PP
PPPPPPPPPPPPPPPPPPPPPPPPPPPPPPPPPPPPPPPPPPPPPPPPPPPPPPPPPPPPPPPPPPPPPPPP
