PPPPPPPPPPPPPPPPPPPPPPPPPPPPPPPPPPPPPPPPPPPPPPPPPPPPPPPP
P                                                      P
P                                                      P
P                                                      P
P                   W +  N                             P
P      D         PPPPPPPPPPP   N                       P
P    PPPP                    PPPPP                     P
P                                  PPP                 P
P                                                 E    P
P          PPP                           PPP   PPPPPP GP
PS       E        N   N                     N         PP
PPPPPPPPPPPPPPPPPPPPPPPPPPPPPPPPPPPPPPPPPPPPPPPPPPPPPPPP
