PPPPPPPPPPPPPPPPPPPPPPPPPPPPPPPPPPPPPPPPPPPPPPPPPPPPPPPPPPPPPPPPPPPPPPPPPPPP
P                                                                          P
P                                                                          P
P                                           +    N           W             P
P                              D   PPP      P  PPPPP         P   PPP       P
P             D    N    T    PPPPP     W                                   P
P        W PPPPPPPPPP  PPP             P PPPPPP      PPP     D             P
P    PPPPP                                                 PPPPP           P
P                       W                       +                          P
P                       P                       P                         GP
PS       N                N     N   E        T                 E TE       PP
PPPPPPPPPPPPPPPPPPPPPPPPPPPPPPPPPPPPPPPPPPPPPPPPPPPPPPPPPPPPPPPPPPPPPPPPPPPP
