PPPPPPPPPPPPPPPPPPPPPPPPPPPPPPPPPPPPPPPPPPPPPPPPPP
P                                                P
P                                                P
P                                                P
P                                                P
P                       E                        P
P       T           N  PPP                       P
P    PPPPPP      PPPPPP W                 D      P
P          PPP          P            D   PPP     P
P                            PPP   PPPP         GP
PS          N                          D        PP
PPPPPPPPPPPPPPPPPPPPPPPPPPPPPPPPPPPPPPPPPPPPPPPPPP
