PPPPPPPPPPPPPPPPPPPPPPPPPPPPPPPPPPPPPPPP
P     W E    E                         P
P S PPPPPPPPPPPPP  P                   P
PPP     +          P                   P
P    PPPPPPPPP     P                   P
P                  P                   P
P     B      E     P      B            P
P  PPPPPPPPPPPPPP  P   PPPPPPPPPPPPPP  P
P                                     GP
PPPPPPPPPPPPPPPPPPPPPPPPPPPPPPPPPPPPPPPP
