PPPPPPPPPPPPPPPPPPPPPPPPPPPPPPPPPPPPPPPP
P                                      P
P                                      P
P     E                                P
P  PPPPPPPP        PPPP     PPPP       P
P                                      P
S                                     GP
P P              P P    P  P     P P   P
P P       E      P P    P  P     P P   P
PPPPPPPPPPPPPPPPPPPPPPPPPPPPPPPPPPPPPPPP
