PPPPPPPPPPPPPPPPPPPPPPPPPPPPPPPPPPPPPPPPPPPPPPPPPPPPPPPPPPPPPPPPPPPPPPPPPP
P                                                                        P
P                                                                        P
P                       T                                    W           P
P                      PPP                             T     P           P
P                                                    PPPP  PPPP  PPPPPP  P
P    PPPPP          +        PPPP                                        P
P                   P                    PPPPPP  W                       P
P           W    WPPPP                         PPPPPP                    P
P          PPP   P                 PPP                                  GP
PS       T          D                D             N             N DN   PP
PPPPPPPPPPPPPPPPPPPPPPPPPPPPPPPPPPPPPPPPPPPPPPPPPPPPPPPPPPPPPPPPPPPPPPPPPP
