PPPPPPPPPPPPPPPPPPPPPPPPPPPPPPPPPPPPPPPPPPPPPPPPPPPPPPPPPPPPPPPPPPPPPP
P                                                                    P
P                                                                    P
P                                             W                      P
P             +        PPP           N        P  E   PPPP            P
P             P                    PPPPP PPP   WPPP                  P
P                  N                           P             N W     P
P                PPPP          W                           PPPPP     P
P    PPPP                    PPP                                     P
P          PPP                                                      GP
PS        ED      N                        D     T         D   T    PP
PPPPPPPPPPPPPPPPPPPPPPPPPPPPPPPPPPPPPPPPPPPPPPPPPPPPPPPPPPPPPPPPPPPPPP
