PPPPPPPPPPPPPPPPPPPPPPPPPPPPPPPPPPPPPPPPPPPPPPPPPPPPPPPPPPPPPPPPPPPPPPPPPPPPPP
P                                                                            P
P                                                                            P
P            T           E           T                      D                P
P         WPPPP        PPPP        PPPPP                   PPP               P
P         P                                             T      +             P
P                PPPP        +                    N  PPPPPP    P             P
P                            P           PPPPPPPPPPPP                  PPPPP P
P     N                        +                          +         TW       P
P    PPP                     PPPPP                        P      PPPPPP     GP
PS   D        D    E            D     TT  N        N              E         PP
PPPPPPPPPPPPPPPPPPPPPPPPPPPPPPPPPPPPPPPPPPPPPPPPPPPPPPPPPPPPPPPPPPPPPPPPPPPPPP
