PPPPPPPPPPPPPPPPPPPPPPPPPPPPPPPPPPPPPPPPPPPPPPPPPPPPPPPPPPPPPPPP
P                                                              P
P                                                              P
P                                                              P
P                  T                                           P
P          PPPPP PPPP                     T          PPPP      P
P     E                PPPPPP            PPP                   P
P    PPP                                  W                    P
P               W               E  PPPPP  P    PPP  +      +   P
P               P            PPPPPP                 P      P  GP
PS             T       N  E N             T  D                PP
PPPPPPPPPPPPPPPPPPPPPPPPPPPPPPPPPPPPPPPPPPPPPPPPPPPPPPPPPPPPPPPP
