PPPPPPPPPPPPPPPPPPPPPPPPPPPPPPPPPPPPPPPPPPPPPPPPPPPPPPPPPPPP
P                                                          P
P                                                          P
P                                                          P
P                PPP                      T                P
P                      PPPPP             PPP               P
P      +                                     +         N   P
P      P                           PPP       P       PPPP  P
P     D    PPPP        +     PPP                E          P
P    PPP               P                       PPP        GP
PS        D                 E      N                TN    PP
PPPPPPPPPPPPPPPPPPPPPPPPPPPPPPPPPPPPPPPPPPPPPPPPPPPPPPPPPPPP
