PPPPPPPPPPPPPPPPPPPPPPPPPPPPPPPPPPPPPPPP
P                                      P
P                                      P
P                                      P
P                                      P
P                 PPPP                 P
P        E                            GP
S       PPPP                  E   PPPPPP
P                         PPPPPPPP     P
PPPPPPPPPPPPPPPPPPPPPPPPPPPPPPPPPPPPPPPP
