PPPPPPPPPPPPPPPPPPPPPPPPPPPPPPPPPPPPPPPPPPPPPPPPPPPPPPPPPPPPPPPPPPPPPPPPPPPPPPPP
P                                                                              P
P                                                                              P
P                             D             T     D                       W    P
P    PPPP  PPP               PPP         PPPPPPPPPPPP N             E     P    P
P                PPPPPP               +              PPP   PPPPPPPPPPPP        P
P                       T           D P                    +             D     P
P                      PPP         PPP                     P           PPPP    P
P           +   +                                                        W     P
P           P   P                                                        P    GP
PS        D          N E D   E                     DE     TT N                PP
PPPPPPPPPPPPPPPPPPPPPPPPPPPPPPPPPPPPPPPPPPPPPPPPPPPPPPPPPPPPPPPPPPPPPPPPPPPPPPPP
