PPPPPPPPPPPPPPPPPPPPPPPPPPPPPPPPPPPPPPPPPPPPPPPPPPPPPPPPPP
P                                                        P
P                                                        P
P      T                                                 P
P    PPPP                    PPPPPP      PPP      E      P
P          PPP            T                    PPPPPP    P
P         W         D  PPPPPP      PPPP                  P
P         P      PPPPPP                             +    P
P            W                                      P    P
P            P                                          GP
PS                                       E T      N T   PP
PPPPPPPPPPPPPPPPPPPPPPPPPPPPPPPPPPPPPPPPPPPPPPPPPPPPPPPPPP
