PPPPPPPPPPPPPPPPPPPPPPPPPPPPPPPPPPPPPPPPPPPPPPPPPPPPPPPPPPPPPP
P                                                            P
P                                                            P
P                                                            P
P                              E                             P
P     N         +            PPPPP        +            E     P
P    PPP        P                         P          PPPP    P
P     W             E              PPPP        PPPPP         P
P     P       D  PPPPPP   D              PPPPPP              P
P          PPPPPP      PPPPPP                               GP
PS   N     E            D     E   E                         PP
PPPPPPPPPPPPPPPPPPPPPPPPPPPPPPPPPPPPPPPPPPPPPPPPPPPPPPPPPPPPPP
