PPPPPPPPPPPPPPPPPPPPPPPPPPPPPPPPPPPPPPPPPPPPPPPPPPPP
P                                                  P
P                                                  P
P                                    E             P
P                                  PPPP            P
P            N           T    +                    P
P     T    PPPP     N  PPPPP  PN                   P
P    PPP         PPPPPP      PPPP+                 P
P                                P                 P
P                                        PPPP     GP
PS           T                 T     E            PP
PPPPPPPPPPPPPPPPPPPPPPPPPPPPPPPPPPPPPPPPPPPPPPPPPPPP
