PPPPPPPPPPPPPPPPPPPPPPPPPPPPPPPPPPPPPPPPPPPPPPPPPPPPPPPPPPPPPPPPPPPP
P                                                                  P
P                                                                  P
P                         T          +                             P
P                      PPPPPP        P         PPPP    T           P
P                 T           T    PPPPP         +   PPPP          P
P             N  PPP         PPP                 P          D      P
P    PWPPPPPPPPPP                                          PPP     P
P     P                                    T                       P
P                                        PPPPP                    GP
PS       N     T  N     T       N           D              T      PP
PPPPPPPPPPPPPPPPPPPPPPPPPPPPPPPPPPPPPPPPPPPPPPPPPPPPPPPPPPPPPPPPPPPP
