PPPPPPPPPPPPPPPPPPPPPPPPPPPPPPPPPPPPPPPPPPPPPPPPPPPPPP
P                                                    P
P                                                    P
P                   W                            N   P
P                   P                          PPPP  P
P                                                    P
P             E  PPPPP          N                    P
P    PPP   PPPPPP            PPPPWPPPPPP             P
P                       T        P                   P
P                      PPP               PPPPP      GP
PS    E         D                               D   PP
PPPPPPPPPPPPPPPPPPPPPPPPPPPPPPPPPPPPPPPPPPPPPPPPPPPPPP
