PPPPPPPPPPPPPPPPPPPPPPPPPPPPPPPPPPPPPPPPPPPPPPPPPPPPPPPPPPPPPPPPPP
P                                                                P
P                                                                P
P                                               T                P
P                                  PPP         PPP         PPPPP P
P                                                                P
P    WPP   PPPP  + E     +                 N                     P
P    P           PPPP    P            +  PPPPP        N          P
P                              N      P              PPP         P
P                      PPP   PPPP                               GP
PS    N        E N      N     D              D                  PP
PPPPPPPPPPPPPPPPPPPPPPPPPPPPPPPPPPPPPPPPPPPPPPPPPPPPPPPPPPPPPPPPPP
