PPPPPPPPPPPPPPPPPPPPPPPPPPPPPPPPPPPPPPPP
P                                      P
P S      E     E                       P
P PPPPPPPPPPPPPPPP P                   P
P                P P                   P
P E     E          P          E        P
PPPPPPPPPPPPPPPP P P      PPPPPPPPPP   P
P                  P                   P
P                P P                  GP
PPPPPPPPPPPPPPPPPPPPPPPPPPPPPPPPPPPPPPPP
